1111111111111111111111111
1000000000000000000000001
1000000000000000000000001
1000000000000000111000001
1011100000000000000000001
1000000000000011100000001
1000000000000000000000001
1000000000111000000000001
1000000000000000000000001
1000000000000000000000001
1000000000000001110000001
1000011100000000000000001
1000000000000000000000001
1001110000000000000000001
1000000000000000000000001
1000000000000001110000001
1000011100000000000000001
1000000000000000000000001
1000000000000000000000001
1000000111000000000000001
1000000000000000000000001
1000000000000000011100001
1000011100000000000000001
1000000000000000000000001
1111111111111111111111111