1111111111111111111111111
1000000000000000000000001
1000000000001000000000001
1000000000001000000000001
1000000000001000000000001
1000010000000000001000001
1000010000000000001000001
1000010000001000001000001
1000000010000100000000001
1000000010000010000000001
1000000010000000000000001
1000000000000000000000001
1000000000000000100000001
1000000000000000100000001
1010000000000000100000001
1010000000000000000000001
1010000000000100000000001
1000000000000010000000001
1000000000000001000000001
1000001000000000000100001
1000001000000000000100001
1000001000000000000100001
1000000000000000000000001
1000000000000000000000001
1111111111111111111111111