1111111111111111111111111
1000000000000000000000001
1000000000000000000000001
1000000000000000000000001
1001000000000010000000001
1000100000000010000000001
1000000000000010000000001
1000100000000000000000001
1001000000000000000000001
1001000000000000010000001
1000100000000000100000001
1000100000000001000000001
1000000000100010000000001
1000000000010000000000001
1000000000001000000000001
1000000000001000000000001
1000000000010000000000001
1000000000100000000000001
1000000000100000001110001
1011100000011000001000001
1000100000000000001000001
1000100000000000000000001
1000000000000000000000001
1000000000000000000000001
1111111111111111111111111