1111111111111111111111111
1000000000000000000000001
1000000000000000000000001
1000000000000000000000001
1001101101101101101101101
1001101101101101101101101
1000000000000000000000001
1001101101101101101101101
1001101101101101101101101
1000000000000000000000001
1001101101101101101101101
1001101101101101101101101
1000000000000000000000001
1000000000000000000000001
1000000000000000000000001
1000000000000000000000001
1000000000000000000000001
1001101101101101101101101
1001101101101101101101101
1000000000000000000000001
1000000000000000000000001
1001101101101101101101101
1001101101101101101101101
1000000000000000000000001
1111111111111111111111111