1111111111111111111111111
1000000000000000000000001
1000000000000000000000001
1000000000000000000000001
1001111111111111111111001
1000000000000000000000001
1000001000000000000000001
1000000100000000000000001
1000000010000000000000001
1000000001000000000000001
1000000000100000000000001
1000000000010000000000001
1000000000001000000000001
1000000000000100000000001
1000000000000010000000001
1000000000000001000000001
1000000000000000100000001
1000000000000000010000001
1000000000000000000000001
1001111111111111111111001
1000000000000000000000001
1000000000000000000000001
1000000000000000000000001
1000000000000000000000001
1111111111111111111111111